WWWWWWWWWWWWWWWWWWWWWWWWWWWWWWWWWWWWWWWWWWWWWWWWWWWWWWWWWWWWWWWW
WJ   D  K  B   D E     K   B   W   K D    B D   K    D  K  E   WW
W                                                            WW
W   D D    K K B B E D D     B K K     D D    K  E   K B D    WW
W                                                            WW
W   K     D   K B     E    K   B B   D     E   K D     K     WW
W                                                            WW
W B     D     B   D   K    D     K   D     K     B    E      WW
W                                                            WW
W K     K   D   B   K     D   B    D     K   D    E     K    WW
W                                                            WW
W D   B   E   K     D   K   D   K     E   K   D      B   K   WW
W                                                            WW
W D     K B     K     E     K     B   K     D     K      K  WW
W                                                            WW
W K B   K     D     K     K     D   B   K     D   K     K    WW
W                                                            WW
W D     K     B   D    K     D    K     B     D    K     E  WW
W                                                            WW
W D     K   E     K     D     K    E     K     D     B     WW
W                                                            WW
W K     B     K     D     K     B   K     D     K     B     WW
W                                                            WW
W K D     K     D     K     D     K     D     K     D     K WW
W                                                            WW
W                                                            WW
W                                                            WW
W                                                            WW
