WWWWWWWWWWWWWWWWWWWWWWWWWWWWWWWWWWWWWWWWWWWWWWWWWWWWWWWWWWW
W     K    D    B   D    W   B     W     K   D  B     D  kW
W WWWWW WWWWW WW  W WWW W WWWWW WWWWW WWWWW WWWWW WWWWW  WW
W W   W     W     W W W W W   W     W W   W     W W   W   W
W W W WWWWW W   W W W W W W WWWW  W W W W WWWWW W W W W  WW
W W W W   W W   W W   W W   W     W W W W   W   W W W W   w
W W W W W W WWW   WWWWW WWWWW W E W W W WWWWWWW W W W W  WW
W W   W W W   K    B   W W     W   W W W       W W W W   WW
W WWWWW W W  WWWW WWWWW W W  WWW  W W WWWWWWW W W W    WWWW
W     W   W   W   W   W W W   W   W   W   B W W   W      WW
WWWWW WWWWW  W W WWW W W W W WW  WWW       W WWWWWWW W    W
W   W W   W  W   W W   W W W       W   W W   W W     W    W
W W W W W W  WWWW WWWWW W W WWWW  W W W WWWW  W WWW W  WWWW
W W   W W     D B   W   W     W K   W   W     W   W W   K W
W WWWWW                                               WWWWW
W W   E     W          W       E     W     E     W      W W
W W  WWWWW   W W   WWW W W WWWWWWWWW W WWWWWWW W W   WW WWW
W   W     W   W     W   W W     W   W     W   W       W W W
W  WWWWWW       wwwW    W                                 w 
W                                 wwwwww                  W
W             wwww            wwww           wwww         w
W        wwww                             wwwww           w   
W     J       wwwww    wwwww       wwwww                  W
W                     E                                   W
WWWWWWWWWWWWWWWWWWWWWWWWWWWWWWWWWWWWWWWWWWWWWWWWWWWWWWWWWWW
