WWWWWWWWWWWWWWWWWWWWWWWWWWWWWWWWWWWWWWWWWWWWWWWWWWWWWWWWWWWWWWWW
WJ  D   B   D   E   B   D   K       B   D   K       D   B   K WW
W                                                            WW
W   D   K   B   D   B   E   K   D   B   K   D   B   E   D     WW
W                                                            WW
W   K   D   B   D   B   K   D   B   K   D   B   D   B   K     WW
W                                                            WW
W D   B   D   B   D   K   B   D   E   B   D   K   B   D   E   WW
W                                                            WW
W B   D   K   D   B   D   B   K   D   B   K   D   B   D   B   WW
W                                                            WW
W E   B   D   B   E   D   B   D   B   D   K   B   D   B   D   WW
W                                                            WW
W   D   B   D   B   D   B   K   D   B   D   B   D   B   D     WW
W                                                            WW
W D   B   D   B   D   K   B   D   B   K   D   B   D   K   E   WW
W                                                            WW
W K   D   B   K   D   B   D   K   B   D   B   D   K   D   B   WW
W                                                            WW
W   D   B   D   B   D   E   B   D   B   D   B   K   D   B     WW
W                                                            WW
W   K   D   B   D   B   K   D   B   E   D   B   D   K   D     WW
W                                                            WW
W   D   B   K   D   B   D   K   B   D   B   D   K   D   B     WW
W                                                            WW
W E   B   D   B   D   B   D   B   K   D   B   D   B   D   K   WW
W                                                            WW
W                                                            WW
W                                                            WW
W                                                            WW
